-------T------
mm---T---T----
mm------------
mm-T----T---T-
mm--T--T-----T
--------------